00 00 00 00 00 00 00 00 00 00 00 00 00 00 00 16 12 12 14 62 00 00 00 00 00 00 00 00 00 00 00 00 00 00 00 00 00 00 00 00 00 00 
00 00 00 00 00 00 00 00 00 00 00 00 00 00 00 16 12 12 14 62 00 00 00 00 00 00 00 00 00 00 00 00 00 00 00 00 00 00 00 00 00 00
00 00 00 00 00 00 00 00 00 00 00 00 00 00 00 16 12 12 14 62 00 00 00 00 00 00 00 00 00 00 00 00 00 00 00 00 00 00 00 00 00 00
00 00 00 00 00 00 00 00 00 00 00 00 00 00 00 16 12 12 14 62 00 00 00 00 00 00 00 00 00 00 00 00 00 00 00 00 00 00 00 00 00 00
00 00 00 00 00 00 00 00 00 00 00 00 00 00 00 16 12 12 14 62 00 00 00 00 00 00 00 00 00 00 00 00 00 00 00 31 00 00 00 00 00 00
00 00 00 00 00 00 00 00 00 00 00 00 00 00 00 16 12 12 14 62 00 00 00 00 00 00 00 00 00 00 00 00 00 31 00 63 00 00 00 00 00 70
00 61 00 00 00 00 00 00 00 00 00 00 00 00 00 16 12 12 14 62 69 00 00 00 00 00 00 00 00 00 00 00 00 63 00 00 00 67 31 00 00 31
01 02 03 66 00 00 00 00 00 00 00 00 00 00 00 16 12 12 14 62 08 00 00 00 00 00 00 67 00 01 02 03 00 00 00 65 00 31 00 00 00 00
11 12 58 03 66 00 00 00 54 00 00 00 00 00 00 16 12 12 14 62 00 00 00 00 00 00 00 31 00 11 12 13 00 67 00 31 00 00 00 00 00 00
11 12 12 58 03 66 00 00 55 00 00 00 00 00 00 16 12 12 14 62 00 00 00 00 61 61 61 61 61 11 12 13 61 31 00 00 00 00 00 00 00 00
11 12 12 12 58 02 02 02 28 10 02 02 43 34 00 16 12 12 14 62 00 00 00 00 01 02 02 02 02 57 12 58 02 20 30 30 30 30 30 30 30 50
11 12 12 12 12 12 12 12 12 12 12 12 14 00 72 21 06 12 14 62 00 00 00 00 11 12 12 12 12 12 12 12 12 12 12 12 12 12 12 12 12 12
11 12 12 12 12 12 12 12 12 12 04 22 53 34 71 00 16 12 14 62 00 00 00 00 11 12 12 12 12 12 12 12 12 12 12 12 12 12 12 12 12 12
11 12 12 12 12 12 12 12 12 12 13 00 00 00 00 01 57 04 23 62 00 00 00 00 11 12 12 12 12 12 12 12 12 12 12 12 12 12 12 12 12 12
11 12 12 12 12 12 12 12 12 12 13 00 32 34 64 21 22 23 00 00 00 00 00 00 11 12 12 12 12 12 12 12 12 12 12 12 12 12 12 12 12 12
11 12 12 12 12 12 12 12 12 12 13 00 00 00 00 00 00 63 00 00 00 00 00 00 11 12 12 12 12 12 12 12 12 12 12 12 12 12 12 12 12 12
11 12 12 12 12 12 12 12 12 12 58 02 02 03 00 00 61 00 67 00 08 00 00 68 11 12 12 12 12 12 12 12 12 12 12 12 12 12 12 12 12 12
11 12 12 12 12 12 12 12 12 12 12 12 12 14 00 01 02 02 02 20 30 30 30 50 57 12 12 12 12 12 12 12 12 12 12 12 12 12 12 12 12 12
11 12 12 12 12 12 12 12 12 12 12 12 12 58 10 57 12 12 12 12 12 12 12 12 12 12 12 12 12 12 12 12 12 12 12 12 12 12 12 12 12 12
